SO ./textures/south.xpm
WE ./textures/west.xpm
EA ./textures/east.xpm
NO ./textures/north.xpm
F 202,206,199
C 128,188,218


11111111111111111111111111111111111
100000000000000W0000000000000100001
10011100000000000000001111111100001
10011100000000000000001000001000001
10011100000000000000001000000000001
10000000000000000000001000001000001
11111111100000000000001111111111111
        100000000000001000000000001111111111
        100000000000001000000000001
11111111100000000000000000000000011
11111111110000001100001111111111111
         10000011000001
         10000011000001
         10000011000001
         10000011000001
         10000011000001
         11111111111111



















