SO ./textures/south.xpm
WE ./textures/west.xpm
EA ./textures/east.xpm
NO ./textures/north.xpm

F 202,206,199
C 128,188,218

111111111111
100101000001
100000000001
1000N0000001
100000001001
100000000001
100000000001
111101000001
111111111111