SO ./textures/south.xpm
WE ./textures/west.xpm
EA ./textures/east.xpm
NO ./textures/north.xpm

F 202,206,199
C 128,188,218

111111111111
110101000011
100000000001
1100N0000011
100000001001
110000000011
100000000001
111101000011
111111111111