SO ./textures/south.xpm
WE ./textures/west.xpm
EA ./textures/east.xpm
NO ./textures/north.xpm

F 202,206,199
C 128,188,218

111111111111
100000100001
110S00100011
100010010001
100110000001
100001100001
100000000001
100000000001
111111111111